あ	ありがとうございます。	短縮よみ	
あ	ありがとうございました。	短縮よみ	
おせ	お世話になっております。	短縮よみ	
おつ	お疲れさまです。	短縮よみ	
おて	お手数をおかけしますが、	短縮よみ	
おね	お願いいたします。	短縮よみ	
よ	よろしくお願いいたします。	短縮よみ	
ふりきゅう	振休	名詞	
ころなか	コロナ禍	名詞	
# ファイナンス
うり	売	名詞	
かい	買	名詞	
げんしさん	原資産	名詞	
こまーしゃるず	コマーシャルズ	固有名詞	
かぶんさん	過分散	名詞	
ていじょうせい	定常性	名詞	
じゃくていじょうせい	弱定常性	名詞	
きょうていじょうせい	強定常性	名詞	
とうぶんさんせい	等分散性	名詞	
さいきがたにゅーらるねっと	再帰型ニューラルネット	名詞	
じこふごうかき	自己符号化器	名詞	
せいていち	正定値	名詞	
せいせいあい	生成 AI 	短縮よみ	
h1	# 	記号	
h2	## 	記号	
h3	### 	記号	
h4	#### 	記号	
h5	##### 	記号	
h6	###### 	記号	
とど	- [ ]  	記号	
だん	- [x]  	記号	
ｍｓ	Microsoft	短縮よみ	
ｃｐ	Copilot	短縮よみ	
ｃｐｓｔ	Copilot Studio	短縮よみ	
ぱ	Power Automate	短縮よみ	
ｍｓｔ	Microsoft 365	短縮よみ	
ｇｐｔ	ChatGPT	短縮よみ	